###########
o #  #    #
# ## # # ##
#      #  x
###########